"STATISTIÈNA REGIJA";"LETO";"Površina (km2) - 1. januar";"Število prebivalcev - 1. julij";"Število moških - 1. julij";"Število žensk - 1. julij";"Gostota naseljenosti - 1. julij"
"Pomurska";"2011";1337;119146;58097;61049;89.1
"Pomurska";"2012";1337;118573;57916;60657;88.7
"Pomurska";"2013";1337;117675;57624;60051;88.0
"Pomurska";"2014";1337;117005;57421;59584;87.5
"Pomurska";"2015";1337;116434;57283;59151;87.1
"Pomurska";"2016";1337;115818;56939;58879;86.6
"Pomurska";"2017";1337;115304;56744;58560;86.2
"Pomurska";"2018";1337;114649;56490;58159;85.9
"Pomurska";"2019";1336;114396;56560;57836;85.6
"Podravska";"2011";2170;322843;159269;163574;148.8
"Podravska";"2012";2170;323026;159525;163501;148.9
"Podravska";"2013";2170;322748;159897;162851;148.7
"Podravska";"2014";2170;323034;160248;162786;148.9
"Podravska";"2015";2170;322545;160172;162373;148.6
"Podravska";"2016";2170;321493;159690;161803;148.2
"Podravska";"2017";2170;321420;159863;161557;148.1
"Podravska";"2018";2170;321960;160698;161262;148.4
"Podravska";"2019";2170;324875;163185;161690;149.7
"Koroška";"2011";1041;72521;36433;36088;69.7
"Koroška";"2012";1041;72267;36255;36012;69.4
"Koroška";"2013";1041;71945;36112;35833;69.1
"Koroška";"2014";1041;71390;35854;35536;68.6
"Koroška";"2015";1041;71218;35755;35463;68.4
"Koroška";"2016";1041;71010;35623;35387;68.2
"Koroška";"2017";1041;70817;35506;35311;68.0
"Koroška";"2018";1041;70603;35508;35095;67.8
"Koroška";"2019";1041;70683;35759;34924;67.9
"Savinjska";"2011";2384;260093;129680;130413;109.1
"Savinjska";"2012";2384;260545;129969;130576;109.3
"Savinjska";"2013";2384;260479;130139;130340;109.3
"Savinjska";"2014";2384;259935;130030;129905;109.0
"Savinjska";"2015";2301;254237;127134;127103;110.5
"Savinjska";"2016";2301;254824;127598;127226;110.7
"Savinjska";"2017";2301;255118;128008;127110;110.9
"Savinjska";"2018";2301;255703;128614;127089;111.1
"Savinjska";"2019";2301;257425;130183;127242;111.9
"Zasavska";"2011";264;44106;21619;22487;167.1
"Zasavska";"2012";264;43775;21431;22344;165.8
"Zasavska";"2013";264;43341;21234;22107;164.2
"Zasavska";"2014";264;42824;20961;21863;162.2
"Zasavska";"2015";485;57567;28340;29227;118.7
"Zasavska";"2016";485;57466;28324;29142;118.5
"Zasavska";"2017";485;57257;28269;28988;118.1
"Zasavska";"2018";485;57050;28201;28849;117.6
"Zasavska";"2019";485;57059;28306;28753;117.6
"Posavska";"2011";885;70086;35135;34951;79.2
"Posavska";"2012";885;70215;35259;34956;79.3
"Posavska";"2013";885;70244;35353;34891;79.4
"Posavska";"2014";885;69994;35275;34719;79.1
"Posavska";"2015";968;75727;38076;37651;78.2
"Posavska";"2016";968;75694;38084;37610;78.2
"Posavska";"2017";968;75422;37888;37534;77.9
"Posavska";"2018";968;75418;38001;37417;77.9
"Posavska";"2019";968;75807;38454;37353;78.3
"Jugovzhodna Slovenija";"2011";2675;142554;71780;70774;53.3
"Jugovzhodna Slovenija";"2012";2675;142749;71776;70973;53.4
"Jugovzhodna Slovenija";"2013";2675;142605;71663;70942;53.3
"Jugovzhodna Slovenija";"2014";2675;142237;71674;70563;53.2
"Jugovzhodna Slovenija";"2015";2675;142356;71733;70623;53.2
"Jugovzhodna Slovenija";"2016";2675;142672;71971;70701;53.3
"Jugovzhodna Slovenija";"2017";2675;142742;72042;70700;53.4
"Jugovzhodna Slovenija";"2018";2675;143382;72650;70732;53.6
"Jugovzhodna Slovenija";"2019";2675;144688;73715;70973;54.1
"Osrednjeslovenska";"2011";2555;534807;261420;273387;209.3
"Osrednjeslovenska";"2012";2555;537712;262946;274766;210.5
"Osrednjeslovenska";"2013";2555;542447;265100;277347;212.3
"Osrednjeslovenska";"2014";2555;547730;267408;280322;214.4
"Osrednjeslovenska";"2015";2334;535375;261490;273885;229.4
"Osrednjeslovenska";"2016";2334;537893;263149;274744;230.5
"Osrednjeslovenska";"2017";2334;540369;264880;275489;231.5
"Osrednjeslovenska";"2018";2334;543964;267071;276893;233.1
"Osrednjeslovenska";"2019";2334;552221;272702;279519;236.6
"Gorenjska";"2011";2137;203703;100637;103066;95.3
"Gorenjska";"2012";2137;204170;100875;103295;95.5
"Gorenjska";"2013";2137;203926;100829;103097;95.4
"Gorenjska";"2014";2137;203894;100933;102961;95.4
"Gorenjska";"2015";2137;203929;100971;102958;95.4
"Gorenjska";"2016";2137;203654;100881;102773;95.3
"Gorenjska";"2017";2137;203705;100941;102764;95.3
"Gorenjska";"2018";2137;203568;101124;102444;95.3
"Gorenjska";"2019";2137;205717;102868;102849;96.3
"Primorsko-notranjska";"2011";1456;52419;26443;25976;36.0
"Primorsko-notranjska";"2012";1456;52423;26432;25991;36.0
"Primorsko-notranjska";"2013";1456;52531;26499;26032;36.1
"Primorsko-notranjska";"2014";1456;52517;26500;26017;36.1
"Primorsko-notranjska";"2015";1456;52551;26557;25994;36.1
"Primorsko-notranjska";"2016";1456;52593;26624;25969;36.1
"Primorsko-notranjska";"2017";1456;52547;26575;25972;36.1
"Primorsko-notranjska";"2018";1456;52315;26461;25854;35.9
"Primorsko-notranjska";"2019";1456;52818;26910;25908;36.3
"Goriška";"2011";2325;119163;59544;59619;51.3
"Goriška";"2012";2325;119230;59459;59771;51.3
"Goriška";"2013";2325;119019;59390;59629;51.2
"Goriška";"2014";2325;118335;59154;59181;50.9
"Goriška";"2015";2325;118196;59102;59094;50.8
"Goriška";"2016";2325;117931;58970;58961;50.7
"Goriška";"2017";2325;117714;58898;58816;50.6
"Goriška";"2018";2325;117353;58858;58495;50.5
"Goriška";"2019";2325;118008;59568;58440;50.7
"Obalno-kraška";"2011";1044;111055;55373;55682;106.4
"Obalno-kraška";"2012";1044;111577;55571;56006;106.9
"Obalno-kraška";"2013";1044;112154;55818;56336;107.4
"Obalno-kraška";"2014";1044;112728;55961;56767;108.0
"Obalno-kraška";"2015";1044;112942;55941;57001;108.2
"Obalno-kraška";"2016";1044;113193;56019;57174;108.4
"Obalno-kraška";"2017";1044;113746;56359;57387;109.0
"Obalno-kraška";"2018";1044;114085;56558;57527;109.4
"Obalno-kraška";"2019";1043;115613;57625;57988;110.8
